{
    "width": 24,
    "height": 14,
    "cellSize": 2.0,
    "objectiveHP": 100.0,
    "cells": [
        0,0,0,0,0,0,0,0,0,0,0,0,0,0,0,0,0,0,0,0,0,0,0,0,
        0,0,0,0,0,0,0,0,0,0,0,0,0,0,0,0,0,0,0,0,0,0,0,0,
        0,0,0,0,0,0,0,0,0,0,0,0,0,0,0,0,0,0,2,0,0,2,0,0,
        0,0,0,0,0,0,0,0,0,0,0,0,0,0,0,0,0,0,0,0,0,0,0,0,
        0,0,0,0,0,0,0,0,0,0,0,0,0,0,0,0,1,1,1,1,1,1,1,5,
        0,0,0,2,0,0,2,0,2,0,0,2,0,0,0,0,1,0,0,0,0,0,0,0,
        0,0,0,0,0,0,0,0,0,0,0,0,0,0,0,0,1,0,0,0,0,0,0,0,
        4,1,1,1,1,1,1,1,1,0,0,0,0,0,0,0,1,0,0,0,0,0,0,0,
        0,0,0,0,0,0,0,0,1,0,0,0,0,0,0,0,0,0,2,0,0,2,0,0,
        0,0,0,2,0,0,2,0,1,0,0,0,0,0,0,0,0,0,0,0,2,0,0,0,
        0,0,0,0,0,0,0,0,1,1,1,1,1,1,1,1,1,0,0,0,0,0,0,0,
        0,0,0,0,0,0,0,0,0,0,0,0,0,0,0,0,0,0,0,0,0,0,0,0,
        0,0,0,0,0,0,0,0,0,0,2,0,0,2,0,0,2,0,0,0,0,0,0,0,
        0,0,0,0,0,0,0,0,0,0,0,0,0,0,0,0,0,0,0,0,0,0,0,0
    ],
    "paths": [
        {
            "routeId": 0,
            "waypoints": [
                [0, 7], [1, 7], [2, 7], [3, 7], [4, 7], [5, 7], [6, 7], [7, 7], [8, 7],
                [8, 8], [8, 9], [8, 10],
                [9, 10], [10, 10], [11, 10], [12, 10], [13, 10], [14, 10], [15, 10], [16, 10],
                [16, 9], [16, 8], [16, 7], [16, 6], [16, 5], [16, 4],
                [17, 4], [18, 4], [19, 4], [20, 4], [21, 4], [22, 4], [23, 4]
            ]
        }
    ]
}
